
NO                 ./textures/colorstone.xpm
SO   ./textures/greystone.xpm
WE     ./textures/bluestone.xpm
EA   ./textures/wood.xpm

F    255,248,220
C 225,206,250

        1111111111111111111111111
111111111000000001111111101111111
        1011000001000110000000011
        1001000001000110000000011
111111111011000000000110000000011
100000000011000000000000000111111
11110000000000000000000000001
11110111111110000000000000001
1100001     10011100000000001
10000011111110001100000000001
10000000000000000000000000001
11000001110101011111000000E0111
11110001 1110101 101000000001
11111111 1111111 111111111111